1111111111111111111111111111111111111111111111111111111111111111111111111111111111111111111111111110
1111111111111111111111111111111111111111111111111111111111111111111111111111111111111111111111111110
1111111111111111111111111111111111111111111111111111111111111111111111111111111111111111111111111110
1111111111111111111111111111111111111111111111111111111111111111111111111111111111111111111111111110
1111111111111111111111111111111111111111111111111111111111111111111111111111111111111111111111111110
1111111111111111111111111111111111111111111111111111111111111111111111111111111111111111111111111110
1111111111111111111111111111111111111111111111111111111111111111111111111111111111111111111111111110
1111111111111111111111111111111111111111111111111111111111111111111111111111111111111111111111111110
1111111111111111111111111111111111111111111111111111111111111111111111111111111111111111111111111110
1111111111111111111111111111111111111111111111111111111111111111111111111111111111111111111111111110
1111111111111111111111111111111111111111111111111111111111111111111111111111111111111111111111111110
1111111111111111111111111111111111111111111111111111111111111111111111111111111111111111111111111110
1111111111111111111111111111111111111111111111111111111111111111111111111111111111111111111111111110
1111111111111111111111111111111111111111111111111111111111111111111111111111111111111111111111111110
1111111111111111111111111111111111111111111111111111111111111111111111111111111111111111111111111110
1111111111111111111111111111111111111111111111111111111111111111111111111111111111111111111111111110
1111111111111111111111111111111111111111111111110000000011111111111111111111111111111111111111111110
1111111111111111111111111111111111111111111111110000000011111111111111111111111111111111111111111110
1111111111111111111111111111111111111111111111110000000011111111111111111111111111111111111111111110
1111111111111111111111111111111111111111111111110000000011111111111111111111111111111111111111111110
1111111111111111111111111111111111111111111111110000000011111111111111111111111111111111111111111110
1111111111111111111111111111111111111111111111110000000011111111111111111111111111111111111111111110
1111111111111111111111111111111111111111111111110000000011111111111111111111111111111111111111111110
1111111111111111111111111111111111111111111111110000000011111111111111111111111111111111111111111110
1111111111111111111111111111111111111111111111110000000011111111111111111111111111111111111111111110
1111111111111111111111111111111111111111111111110000000011111111111111111111111111111111111111111110
1111111111111111111111111111111111111111111111110000000011111111111111111111111111111111111111111110
1111111111111111111111111111111111111111111111110000000011111111111111111111111111111111111111111110
1111111111111111111111111111111111111111111111110000000011111111111111111111111111111111111111111110
1111111111111111111111111111111111111111111111110001100011111111111111111111111111111111111111111110
1111111111111111111111000000000000000000000000000000000000000000000000000000000000000000000000111110
1111111111111111111111000000000000000000000000000000000000000000000000000000000000000000000000111110
1111111111111111111111000011101110111000000000000000000000000011101110111000001110111011100000111110
1111111111111111111111000000000000000000000000000000000000000000000000000000000000000000000000111110
1111111111111111111111000000000000000000000000000000000000000000000000000000000000000000000000111110
1111111111111111111111000000000000000000000000000000000000000000000000000000000000000000000000111110
1111111111111111111111001000000000000000000000000000000000000000000000000001100000000000000100111110
1111111111111111111111001000000000000000000000000000000000000000000000000001100000000000000100111110
1111111111111111111111001000000000000000000000000000000000000000000000000001100000000000000100111110
1111111111111111111111000000000000000000000000000000000000000000000000000000000000000000000000111110
1111111111111111111111001000000000000000000000000000000000000000000000000000000000000000000100111110
1111111111111111111111001000000000000000000000000000000000000000000000000000000000000000000100111110
1111111111111111111111001000000000000000000000000000000000000000000000000000000000000000000100111110
1111111111111111111111011000000000000000000000000000000000000000000000000000000000000000000110111110
1111111111111111111111011000000000000000000000000000000000000000000000000000000000000000000110111110
1111111111111111111111000000000000000000000000000000000000000000000000000000000000000000000000111110
1111111111111111111111000011000011110000111100001111000011110000111100001111000011110000110000111110
1111111111111111111111000011000011110000111100001111000011110000111100001111000011110000110000111110
1111111111111111111111000011000011110000111100001111000011110000111100001111000011110000110000111110
1111111111111111111111000011000011110000111100001111000011110000111100001111000011110000110000111110
1111111111111111111111000011000011110000111100001111000011110000111100001111000011110000110000111110
1111111111111111111111111111000011110000111100001111000011110000111100001111000011110000111111111110
1111111111111111111111111111000011110000111100001111000011110000111100001111000011110000111111111110
1111111111111111111111111111000011110000111100001111000011110000111100001111000011110000111111111110
1111111111111111111111111111000011110000111100001111000011110000111100001111000011110000111111111110
1111111111111111111111111111000011110000111100001111000011110000111100001111000011110000111111111110
1111111111111111111111111100000000000000000000000000000000000000000000000000000000000000001111111110
1111111111111111111111111100000000000000000000000000000000000000000000000000000000000000001111111110
1111111111111111111111111100000000000000000000000000000000000000000000000000000000000000001111111110
1111111111111111111111111100000000000000000000000000000000000000000000000000000000000000001111111110
1111111111111111111111111100000000000000000000000000000000000000000000000000000000000000001111111110
1111111111111111111111111110000001000000010000000100000001000000010000000100000001000000011111111110
1111111111111111111111111110000001000000010000000100000001000000010000000100000001000000011111111110
1111111111111111111111111110000001000000010000000100000001000000010000000100000001000000011111111110
1111111111111111111111111110000001000000010000000100000001000000010000000100000001000000011111111110
1111111111111111111111111110000001000000010000000100000001000000010000000100000001000000011111111110
1111111111111111111111111110000001000000010000000100000001000000010000000100000001000000011111111110
1111111111111111111111111110000001000000010000000100000001000000010000000100000001000000011111111110
1111111111111111111111111110000001000000010000000100000001000000010000000100000001000000011111111110
1111111111111111111111111110000001000000010000000100000001000000010000000100000001000000011111111110
1111111111111111111111111110000000000000000000000000000000000000000000000000000000000000011111111110
1111111111111111111111111110000000000000000000000000000000000000000000000000000000000000011111111110
1111111111111111111111111110000000000000000000000000000000000000000000000000000000000000011111111110
1111111111111111111111111110000001000000010000000100000001000000010000000100000001000000011111111110
1111111111111111111111111110000001000000010000000100000001000000010000000100000001000000011111111110
1111111111111111111111111110000001000000010000000100000001000000010000000100000001000000011111111110
1111111111111111111111111110000001000000010000000100000001000000010000000100000001000000011111111110
1111111111111111111111111110000001000000010000000100000001000000010000000100000001000000011111111110
1111111111111111111111111110000001000000010000000100000001000000010000000100000001000000011111111110
1111111111111111111111111110000001000000010000000100000001000000010000000100000001000000011111111110
1111111111111111111111111110000001000000010000000100000001000000010000000100000001000000011111111110
1111111111111111111111111110000001000000010000000100000001000000010000000100000001000000011111111110
1111111111111111111111111110000001000000010000000100000001000000010000000100000001000000011111111110
1111111111111111111111111110000001000000010000000100000001000000010000000100000001000000011111111110
1111111111111111111111111111111111111111111111111111111111111111111111111111111111111111111111111110
1111111111111111111111111111111111111111111111111111111111111111111111111111111111111111111111111110
1111111111111111111111111111111111111111111111111111111111111111111111111111111111111111111111111110
1111111111111111111111111111111111111111111111111111111111111111111111111111111111111111111111111110
1111111111111111111111111111111111111111111111111111111111111111111111111111111111111111111111111110
1111111111111111111111111111111111111111111111111111111111111111111111111111111111111111111111111110
1111111111111111111111111111111111111111111111111111111111111111111111111111111111111111111111111110
1111111111111111111111111111111111111111111111111111111111111111111111111111111111111111111111111110
1111111111111111111111111111111111111111111111111111111111111111111111111111111111111111111111111110
1111111111111111111111111111111111111111111111111111111111111111111111111111111111111111111111111110
1111111111111111111111111111111111111111111111111111111111111111111111111111111111111111111111111110
1111111111111111111111111111111111111111111111111111111111111111111111111111111111111111111111111110
1111111111111111111111111111111111111111111111111111111111111111111111111111111111111111111111111110
1111111111111111111111111111111111111111111111111111111111111111111111111111111111111111111111111110
1111111111111111111111111111111111111111111111111111111111111111111111111111111111111111111111111110
0000000000000000000000000000000000000000000000000000000000000000000000000000000000000000000000000000
